   NO           ./textures/north.xpm
SO     ./textures/south.xpm
        WE ./textures/west.xpm
EA                    ./textures/east.xpm
      F      220,  100 ,   0
   C   100 ,100,255
                1111111111
                1N00000001
                1000000001
                1111111111

