NO ./textures/north.xpm
SO ./textures/south.xpm
WE ./textures/west.xpm
EA ./textures/east.xpm
F 220,100,0
C 100,100,255

111111111111
100000000001
100011111101
10N010000101
100011111101
100000000001
111111111111

