NO ./textures/north.xpm
SO ./textures/south.xpm
WE ./textures/west.xpm
EA ./textures/east.xpm
F 256,100,0
C 100,100
111111
1N0001
100001
111111

